-18
55
-36
12
00000000000000000000000000000000000000000000000000000000000000000000000000
11111111111111111111111111111111111111111111111111111111111111111111111110
10000000000000000000000000000000000000000000000000000000000000000000000010
10111111110000000000000000000000000000000000000000000000000000000000000010
10100000010000000000000000000000000000000000000011111100000000000000000010
10100000011110000111000000000000000000000000000011111100000000000000000010
10100000011110110111000000000111111100000000000011111100000000000000000010
10100000011110110000000000000111111100010000000011111100000001000000000010
10111111111110000000000000000111111100000000000000000000000000000000000010
10000000010010000000000000000000000000000000000000000000000000000000000010
10000000000000000000000000000000000000000000000000000000000000000000000010
10000000000000000000000000000000000000000000000000000000000000000000000010
10000000000000000000000000000000000000000000000000000000000000000000000010
10000000000000000000000000000000000000000000000000000000000000000000010010
10000000000000000000000000000000000000000000000000000000000000000000000010
10000000000000000000000000000000000000000000000000000000000000000000000010
10000000000000000000000000000000000000000000000000000000000000000000000010
10000000000000000000000000000000000000000000000000000000000000000000000010
10000000000000000000000000000000000000000000000000000000000000000000000010
10000000000000000000000000000000000000000000000000000000000000000001010010
10000000000000000000000000000000000000000000000000000000000000000000000010
10000000000000000000000000000000000000000000000000000000000000000000000010
10000000000000000000000000001000000000000001000000000000000000000000000010
10000000000000010000010000000000000000000000000000000000000000000000000010
10010000000000000000000000000000000000001000000010000000000000000000000010
10000000010000000000000000000010000000000000000000000010000000000000001010
10000000000000000000000010000000000010000000000000000000000000000000000010
10000010000000001000000000000000010000000000000000000000000000000000001010
10000000000000000000000000000000000000000000000000000000000000000000000010
10000000000000000000000000000000000000000000000000000000000000000000000010
10000000011111111111111111111111111111110000000000000000000000000000000010
10000000011111111111111111111111111111110000000000000000000000000000000010
10000000011111111111111111111111111111110000000000000000000000000000000010
10000000011111111111111111111111111111110000000000000010000000000000000010
10000000011111111111111111111111111111110100000000000000000100000000000010
10000000011111111111111111111111111111110000000000000000000000000000000010
10000000011111111111111111111111111111111000000000000000000000000000000010
10000000011111111111111111111111111111110100000000001111111000000000000010
10000010011111111111111111111111111111110000000000111111111000000000000010
10000000011111111111111111111111111111110000000000111111111110000000000010
10000000011111111111111111111111111111110000010000001111111100000000000010
10000000000000000000000000000000000100000010000000000000000000000001000010
10000000100000000000000000000000000000000000000000000000000000000000010010
10000000000000000000000000000000000000000000000000000000000000000000000010
10000000000000000000000000000000000000000000000000000000000000000000000010
10010000000000010001000100000000000000000000000001000000000000000000001010
10000100000001000100000000000001010000010010000010000100000000000000100010
10000000000000000000000000000000000000000000000000000000000000000000000010
11111111111111111111111111111111111111111111111111111111111111111111111110
